^--------
=--=-=---
====-====
=----=-==
==-=---==
==--=-===
===--=---
===v=====
=========